16
21
0 0 0 0 0 0 0 0 0 0 0 0 0 0 0 0 0 0 0 0 0
0 0 0 0 0 0 0 0 0 0 0 0 0 0 0 0 0 0 0 0 0
0 0 0 0 0 0 0 0 0 0 0 0 0 0 0 0 0 0 0 0 0
0 0 0 0 0 0 0 0 0 0 0 0 0 0 0 0 0 0 0 0 0
0 0 0 0 0 0 0 0 0 0 0 0 0 0 0 0 0 0 0 0 0
0 0 0 0 0 0 0 0 0 0 0 0 0 0 0 0 0 0 0 0 0
0 0 0 0 0 0 0 0 0 0 0 0 0 0 0 0 0 0 0 0 0
0 0 0 0 0 0 0 0 0 0 0 0 0 0 0 0 0 0 0 0 0
0 0 0 0 0 0 0 0 0 0 0 0 0 0 0 0 0 0 0 0 0
0 0 0 0 0 0 0 0 0 0 0 0 0 0 0 0 0 0 0 0 0
0 0 0 0 0 0 0 0 0 0 0 0 11 12 12 12 12 12 12 14 0
0 0 0 11 12 12 12 14 0 0 11 12 12 13 13 13 13 13 13 14 0
11 13 13 13 13 13 13 14 0 0 11 13 13 13 13 13 13 13 13 14 0
11 13 13 13 13 13 13 14 0 0 11 13 13 13 13 13 13 13 13 14 0
11 13 13 13 13 13 13 14 0 0 11 13 13 13 13 13 13 13 13 14 0
11 13 13 13 13 13 13 14 0 0 11 13 13 13 13 13 13 13 13 14 0


11 - левая сторона
12 - блок с крышкой
13 - блок без крышки
14 - правая сторона