15
21
0 0 0 0 0 0 0 0 0 0 0 0 0 0 0 0 0 0 0 0 0
0 0 0 0 0 0 0 0 0 0 0 0 0 0 0 0 0 0 0 0 0
0 0 0 0 0 0 0 0 0 0 0 0 0 0 0 0 0 0 0 0 0
0 0 0 0 0 0 0 0 0 0 0 0 0 0 0 0 0 0 0 0 0
0 0 0 0 0 0 0 0 0 0 0 0 0 0 0 0 0 0 0 0 0
0 0 0 0 0 0 0 0 0 0 0 0 0 0 0 0 0 0 0 0 0
0 0 0 0 0 0 0 0 0 0 0 0 0 0 0 0 0 0 0 0 0
0 0 0 0 0 0 0 0 0 0 0 0 0 0 0 0 0 0 0 0 0
22 13 0 0 0 0 0 0 0 0 0 0 0 0 0 0 0 0 12 22 22
23 13 0 0 0 0 0 0 0 0 0 0 0 0 0 0 0 0 12 23 23
23 13 0 0 0 0 0 0 0 0 0 0 0 0 0 0 0 0 12 23 23
23 13 0 0 0 0 0 0 0 0 0 0 0 0 0 0 0 0 12 23 23
23 13 0 0 0 0 0 0 0 0 0 0 0 0 0 0 0 0 12 23 23
23 13 32 32 32 32 32 32 32 32 32 32 32 32 32 32 32 32 12 23 23
23 22 22 22 22 22 22 22 22 22 22 22 22 22 22 22 22 22 22 23 23